{
  "3"  : "0",
  "1"  : "3",
  "2"  : "1",
  "4"  : "4",
  "6"  : "0",
  "19" : "0",
  "73" : "0",
  "76" : "14"
}